########
###...##
#+@O..##
###.O+##
#+##O.##
#.#.+.##
#O.XOO+#
#...+..#
########

